6,6,6,6,6,6,6,6,6,6,6,6,4,6,6,6,6,6
6,6,6,3,6,6,6,6,6,6,6,6,6,6,6,6,6,6
6,6,6,6,6,6,6,6,6,6,6,6,4,6,6,6,3,6
6,6,6,4,6,6,3,3,3,6,3,6,6,6,6,6,6,6
6,6,6,3,6,6,4,3,3,3,3,3,4,3,6,6,3,6
6,6,6,4,6,3,4,3,3,3,4,3,3,3,6,6,6,6
6,6,6,6,6,4,3,4,4,4,3,4,4,6,6,3,6,3
6,3,6,4,3,3,3,4,4,3,3,3,3,3,6,3,6,6
3,6,6,6,6,4,3,3,4,5,4,3,3,6,6,6,6,6
6,6,6,6,4,4,4,3,5,4,3,3,3,6,6,6,6,6
6,6,6,6,6,6,6,3,5,6,6,6,6,6,6,6,6,6
