0,0,0,0,0,2,2,2,2,2,2,2,0,0,0,0,0,0
0,0,0,0,2,2,3,3,3,3,3,3,2,0,0,0,0,0
0,0,0,2,2,3,4,4,4,4,4,4,3,2,0,0,0,0
0,0,2,2,3,4,1,1,1,1,1,1,4,3,2,0,0,0
0,2,2,3,4,1,0,0,0,0,0,0,1,4,3,2,0,0
0,2,3,4,1,0,0,0,0,0,0,0,0,1,4,3,2,0
0,5,3,1,0,0,0,0,0,0,0,0,0,0,1,4,3,5
5,5,5,1,0,0,0,0,0,0,0,0,0,0,5,5,5,5
5,5,5,5,0,0,0,0,0,0,0,0,0,5,5,5,5,5
0,5,5,5,5,0,0,0,0,0,0,0,0,0,5,5,5,5
0,0,5,5,5,0,0,0,0,0,0,0,0,0,0,5,5,0

